||||||||||||||||||||||||||||||
|........|...................|
|.S......|.........|.........|
|........|||||||||||.........|
|.......V|.........|.........|
|....@.............|.........|
|........|.........|.........|
|S.......|...................|
|........|.........|.........|
||||||||||||||||||||.........|
|............................|
|............................|
|......F.....................|
|............................|
|............................|
|............................|
|...................&........|
|............................|
|............................|
||||||||||||||||||||||||||||||


||||||||||
|........|
|........|
|.S...S..|
|........|
|........|
||||||||||